#######################################%%%####################################
#                   #                                       #                #
# #### ####### #### # ###### # ######## # ######## # ###### # #### ######### #
# ####         #### # ###### #          #          # ###### # #### ######### #
# #### ####### #### # ###### # ######## # ######## # ###### # #### ######### #
# #                                                                          #
# # ####### ####### #################### #################### ####### ########
# # ##      ####### #                                       # #######      ###
# # ## ############ # ######## #### #$##-##$# #### ######## # ############ ###
%@                                  #%%%%%%%#                                %
# # ## ############ # ######## #### #$##-##$# #### ######## # ############ ###
# # ##      ####### #                                       # #######      ###
# # ####### ####### #################### #################### ####### ########
# #                                                                          #
# #### ####### #### # ###### # ######## # ######## # ###### # #### ######### #
# ####         #### # ###### #          #          # ###### # #### ######### #
# #### ####### #### # ###### # ######## # ######## # ###### # #### ######### #
#                   #                                       #                #
#######################################%%%####################################
                &